150
20
parcour
4
25
30
10 10 0 0 0 0 15 15 15 15 15 15 15 15 15 15 15 0 0 0 0 0 15 15 15 15 15 15 15 15 15 15 15 15 15 15 15 15 15 15 9 9 9 9 9 9 9 9 9 9 9 9 9 9 9 0 0 0 0 0 0 0 0 0 0 0 0 0 0 14 14 14 0 0 0 0 0 0 0 0 0 0 0 0 0 0 9 9 9 9 9 9 9 9 9 9 9 9 9 9 9 9 9 9 9 9 9 9 9 9 9 9 9 9 9 9 9 9 9 9 9 9 9 9 9 9 9 9 9 9 9 9 9 9 9 9 9 9 9 9 9 9 9 9 9 9 9 9 10 10 
10 10 0 0 0 0 0 15 15 15 15 15 15 0 15 15 0 0 0 0 6 0 0 15 15 15 15 15 15 15 15 15 15 15 15 15 15 15 15 15 9 9 9 9 9 9 9 9 9 9 9 9 9 9 9 0 0 0 0 0 0 0 0 0 0 0 0 0 0 14 14 14 0 0 0 0 0 0 0 0 0 0 0 0 0 0 9 9 9 9 9 9 9 9 9 9 9 9 9 9 9 9 9 9 9 9 9 9 9 9 9 9 9 9 9 9 9 9 9 9 9 9 9 9 9 9 9 9 9 9 9 9 9 9 9 9 9 9 9 9 9 9 9 9 9 9 9 9 10 10 
10 0 0 0 0 0 0 0 15 15 15 15 0 0 0 15 0 0 0 0 14 0 0 15 15 15 15 15 15 15 15 15 15 15 15 15 15 15 15 9 9 9 9 9 9 9 9 9 9 9 9 9 9 9 9 0 0 0 0 0 0 0 0 0 0 0 0 0 0 14 14 14 0 0 0 0 0 0 0 0 0 0 0 0 0 0 9 9 9 9 9 0 9 9 9 9 9 9 9 9 9 9 9 9 9 14 9 9 9 9 9 9 9 9 9 9 9 9 9 9 9 9 9 9 9 9 9 9 9 9 9 9 9 9 9 9 9 9 9 9 9 9 9 9 9 9 9 9 0 10 
10 0 0 0 0 0 0 0 15 15 15 0 0 6 0 0 0 0 0 0 14 0 0 0 15 15 15 15 15 15 15 15 15 15 15 15 15 15 9 9 9 9 9 9 9 9 9 9 9 9 9 9 9 9 9 0 0 0 0 0 0 0 0 0 0 0 0 0 0 14 14 14 0 0 0 0 0 0 0 0 0 0 0 0 0 0 9 9 9 9 14 0 9 9 9 9 9 9 9 9 9 9 9 9 9 9 14 9 9 9 9 9 9 9 9 9 9 9 9 9 9 9 9 9 9 9 9 9 9 9 9 9 9 9 9 9 9 9 9 9 9 9 9 9 9 9 9 9 0 10 
10 10 0 0 6 0 0 0 0 15 15 0 0 14 0 0 0 4 4 15 0 0 0 15 15 15 15 15 15 15 15 15 15 15 15 15 15 15 9 9 9 9 9 9 9 9 9 9 9 9 9 9 9 9 9 0 0 0 0 0 0 0 0 0 0 0 0 0 0 14 14 14 0 0 0 0 0 0 0 0 0 0 0 0 0 0 9 9 9 9 14 0 9 9 9 9 9 9 9 9 9 9 4 9 9 9 9 14 9 9 9 9 9 9 9 9 9 9 9 9 9 9 9 9 9 9 9 9 9 9 9 9 9 9 9 9 9 9 9 9 9 9 9 9 9 9 9 9 10 10 
10 10 0 0 14 0 0 0 15 15 0 0 0 14 0 0 0 15 15 15 15 0 0 15 15 15 15 15 15 15 15 15 15 15 15 15 15 15 9 9 9 9 9 9 9 9 9 9 9 9 9 9 9 9 9 14 14 14 14 14 14 14 14 14 14 14 14 14 14 14 14 14 14 14 14 14 14 4 4 14 14 14 14 4 4 4 9 9 9 9 14 4 4 4 4 9 9 9 9 9 9 4 14 9 9 9 9 14 4 9 9 9 9 9 9 9 9 9 9 9 9 9 9 9 9 9 9 9 9 9 9 9 9 9 9 9 9 9 9 9 9 9 9 9 9 4 4 4 10 10 
4 4 0 0 14 0 0 0 15 0 0 0 0 0 0 0 0 15 15 15 15 0 0 0 15 15 15 15 15 15 15 15 15 15 15 15 9 9 9 9 9 9 9 9 9 9 9 9 9 9 9 9 9 2 2 2 9 9 9 2 9 9 9 9 9 9 9 9 9 14 14 14 9 9 9 9 9 9 9 9 9 9 9 9 9 9 9 9 9 9 14 14 14 14 14 14 14 14 14 9 4 14 0 0 9 9 9 9 14 4 9 9 9 9 9 9 9 9 9 9 9 9 9 9 9 9 9 9 4 9 9 9 9 9 9 9 9 9 9 9 9 9 9 9 4 13 13 13 13 9 
15 15 0 0 0 0 0 15 15 0 6 0 0 0 0 0 0 15 15 15 15 0 0 0 15 15 15 15 15 15 15 15 15 15 15 0 9 9 9 9 9 9 9 9 9 9 9 9 9 9 9 2 2 9 9 9 2 2 9 2 9 9 9 9 9 9 9 9 9 14 14 14 9 9 9 9 9 9 9 9 9 9 9 9 9 9 9 9 9 14 14 14 14 14 14 14 14 14 14 9 9 14 0 0 0 0 9 9 9 14 4 9 9 9 9 9 9 9 9 9 9 9 9 9 9 9 9 9 14 4 9 9 9 9 9 9 9 9 9 9 9 9 9 4 13 13 13 13 13 9 
15 15 0 2 0 0 0 0 15 0 14 0 0 0 4 4 15 15 15 15 15 0 0 0 0 15 15 15 15 15 15 0 0 0 0 0 9 9 9 9 9 9 9 9 9 9 9 9 9 9 2 9 9 9 9 9 9 9 2 2 9 9 9 9 9 9 9 9 9 14 14 14 9 9 9 9 9 9 9 9 9 9 9 9 9 9 9 9 9 14 14 5 5 5 5 14 14 5 5 9 14 14 0 0 0 0 0 9 9 14 14 9 9 9 9 9 9 9 9 9 9 9 9 9 9 9 9 14 14 14 4 9 9 9 9 9 9 9 9 9 9 9 9 9 13 13 14 13 13 13 
15 15 0 0 2 0 0 2 15 0 14 0 0 0 0 15 15 15 15 15 15 0 0 6 0 15 15 15 15 15 0 0 0 0 0 0 9 9 9 9 9 9 9 9 9 9 9 9 9 2 9 9 9 9 9 9 2 2 2 2 9 9 9 9 9 9 9 9 9 14 14 14 9 9 9 9 9 9 9 9 9 9 9 9 9 9 9 9 9 14 14 5 5 5 5 14 14 5 5 9 14 0 0 0 0 0 0 9 9 14 14 14 9 9 9 9 9 9 9 9 9 9 9 9 9 4 14 14 14 14 14 9 9 9 9 9 4 4 4 9 9 9 9 13 13 14 14 14 13 13 
15 15 15 0 0 2 0 2 0 0 0 0 0 0 0 15 15 15 15 15 15 15 0 14 0 15 15 15 15 15 0 0 0 0 0 0 9 9 14 4 4 4 14 9 9 9 9 9 9 9 9 9 9 9 9 9 9 9 9 9 9 9 9 9 9 9 9 9 9 14 14 14 4 4 9 9 9 9 9 9 9 9 9 9 9 9 9 9 9 14 14 5 5 5 5 14 14 5 5 14 14 0 0 0 0 0 0 9 9 14 14 14 14 9 9 9 9 9 9 7 9 9 9 9 4 14 14 14 5 14 14 14 9 9 9 9 9 9 9 9 9 9 9 13 13 13 14 13 13 13 
15 15 15 0 0 0 2 2 0 0 0 4 4 15 15 15 15 15 15 15 15 15 0 14 0 15 15 15 15 0 6 0 0 0 0 0 9 9 9 9 9 9 14 14 14 14 14 4 4 4 9 9 9 9 14 14 0 0 0 0 0 0 0 14 14 9 9 9 9 14 14 14 9 9 9 14 14 0 0 0 0 0 0 0 0 14 14 9 9 14 14 14 14 14 14 14 14 14 14 14 9 9 9 0 0 0 9 9 9 14 14 14 14 14 9 9 9 9 7 6 7 7 4 4 14 14 14 5 5 5 14 14 14 9 9 9 9 9 9 9 9 9 13 13 13 13 14 14 13 13 
15 15 15 15 2 2 2 2 0 0 0 0 15 15 15 15 15 15 15 15 15 15 0 0 0 15 15 15 15 0 14 0 4 4 4 4 9 9 9 9 9 9 9 9 9 9 9 14 14 14 14 14 14 14 14 14 0 0 0 0 0 0 0 14 14 14 14 14 14 14 14 14 14 14 14 14 14 0 0 0 0 0 0 0 0 14 14 14 14 14 14 14 14 14 14 14 14 14 14 14 9 9 9 9 9 0 9 9 9 9 14 14 0 14 14 9 9 7 6 6 6 6 7 9 9 14 14 14 5 14 14 14 14 9 9 9 9 9 9 9 9 9 13 9 13 13 13 14 9 13 
15 15 15 15 0 0 0 0 0 0 0 15 15 15 15 15 15 15 15 15 15 15 0 0 0 0 15 0 0 0 14 0 15 15 15 15 9 9 9 9 9 9 9 9 9 9 9 9 9 14 14 14 14 0 14 14 6 6 6 6 6 6 6 7 6 6 6 6 6 6 7 6 6 6 6 6 7 6 6 6 6 6 6 6 6 7 14 14 14 14 14 14 14 14 14 14 14 14 14 9 9 9 9 9 9 9 9 9 9 9 0 0 0 14 14 14 7 6 6 6 6 6 7 9 9 9 14 14 14 14 14 14 14 9 9 9 9 9 9 9 9 9 9 9 9 9 13 14 14 9 
15 15 15 15 15 0 4 4 4 4 0 15 15 15 15 15 15 15 15 15 15 15 0 0 0 0 0 0 0 0 0 0 15 15 15 15 9 9 9 9 9 9 9 9 9 9 9 9 9 9 14 14 0 0 0 14 6 6 6 6 6 6 6 6 6 6 6 6 6 6 6 6 6 6 6 6 6 0 0 4 4 4 4 0 0 6 14 14 6 0 0 6 14 14 5 5 5 5 0 0 9 9 9 9 9 9 9 9 9 9 14 0 0 0 14 14 14 4 4 4 6 6 7 7 9 9 9 14 14 14 14 14 14 14 14 9 9 9 9 9 9 9 9 9 9 9 9 9 14 9 
15 15 15 15 15 15 15 15 15 15 15 15 15 15 15 15 15 15 15 15 15 15 4 4 0 0 0 0 0 4 15 15 15 15 15 15 15 9 9 9 9 9 9 9 9 9 9 9 9 9 9 14 14 0 14 14 6 6 6 6 6 6 6 6 6 6 6 6 6 6 6 6 6 6 6 6 15 0 0 15 6 6 15 0 0 15 14 14 15 0 0 15 14 14 5 5 5 5 0 0 9 9 9 9 9 9 9 9 9 9 9 14 0 14 14 14 14 14 2 6 6 6 7 6 7 7 9 9 14 14 14 14 14 14 14 9 9 9 9 9 9 9 9 9 9 9 9 9 14 9 
15 15 15 15 15 15 15 15 15 15 15 15 15 15 15 15 15 15 15 15 15 15 15 15 4 0 0 0 4 15 15 15 15 15 15 15 15 9 9 9 9 9 9 9 9 9 9 9 9 9 9 14 14 14 14 14 6 6 6 6 6 6 6 6 6 6 6 6 6 6 6 6 6 6 6 4 15 6 6 15 6 6 15 6 6 15 14 14 15 6 6 15 14 14 5 5 5 5 14 14 14 14 9 9 9 9 9 9 9 9 9 9 14 14 14 14 14 14 14 2 6 6 6 6 6 6 7 14 14 14 14 14 14 14 9 9 9 9 9 9 9 9 9 9 9 9 6 6 6 6 
15 15 15 15 15 15 15 15 15 15 15 15 15 15 15 15 15 15 15 15 15 15 15 15 15 4 4 4 15 15 15 15 15 15 15 15 15 15 3 3 3 3 3 3 3 3 3 3 3 3 3 3 14 14 14 14 4 4 4 4 4 4 4 6 6 6 6 4 4 4 6 6 6 6 4 6 15 6 6 15 6 6 15 6 6 15 14 14 14 14 14 14 14 14 14 14 14 14 14 14 14 14 14 3 3 3 3 3 3 3 3 3 3 3 3 3 3 3 3 3 3 3 3 3 3 3 3 3 3 3 3 3 3 3 3 3 3 3 3 3 3 3 6 6 6 6 14 14 14 14 
15 15 15 15 15 15 15 15 15 15 15 15 15 15 15 15 15 15 15 15 15 15 15 15 15 15 15 15 15 15 15 15 15 15 15 15 15 15 15 3 3 3 3 3 3 3 3 3 3 3 3 3 3 14 14 14 14 14 14 14 14 14 14 14 14 14 14 14 14 14 14 14 14 14 14 14 14 14 14 14 14 14 14 14 14 14 14 14 14 14 14 14 14 14 14 14 14 14 14 14 14 14 14 3 3 3 3 3 3 3 3 3 3 3 3 3 3 3 3 3 3 3 3 3 3 3 3 3 3 3 3 3 3 3 3 3 3 3 3 6 6 6 14 14 14 14 14 14 14 14 
15 15 15 15 15 15 15 15 15 15 15 15 15 15 15 15 15 15 15 15 15 15 15 15 15 15 15 15 15 15 15 15 15 15 15 15 15 15 15 3 3 3 3 3 3 3 3 3 3 3 3 3 3 3 14 14 14 14 14 14 14 14 14 14 14 14 14 14 14 14 14 14 14 14 14 14 14 14 14 14 14 14 14 14 14 14 14 14 14 14 14 14 14 14 14 14 14 14 14 14 14 14 14 3 3 3 3 3 3 3 3 3 3 3 3 3 3 3 3 3 3 3 3 3 3 3 3 3 3 3 3 3 3 6 6 6 6 6 6 14 14 14 14 14 14 14 14 14 14 14 
