100
30
5 5 5 5 5 5 5 5 5 5 5 5 5 5 5 5 5 5 5 5 5 5 5 5 5 5 5 5 5 5 5 5 5 5 5 5 5 5 5 5 5 5 5 5 5 5 5 5 5 5 5 5 5 5 5 5 5 5 5 5 5 5 5 5 5 5 5 5 5 5 5 5 5 5 5 5 5 5 5 5 5 5 5 5 5 5 5 5 5 5 5 6 6 6 5 5 6 6 6 6 
5 5 5 5 5 5 5 5 5 5 5 5 5 5 5 5 5 5 5 5 5 5 5 5 5 5 5 5 5 5 5 5 5 5 5 5 5 5 5 5 5 5 5 5 5 5 5 5 5 5 5 5 5 5 5 5 5 5 5 5 5 5 5 5 5 5 5 5 5 5 5 5 5 5 5 5 5 5 5 5 5 5 5 5 5 5 5 5 5 5 5 5 5 6 6 6 6 6 6 6 
5 5 5 5 5 5 5 5 5 5 5 5 5 5 5 5 5 5 5 5 5 5 5 5 5 5 5 5 5 5 5 5 5 5 5 5 5 5 5 5 5 5 5 5 5 5 5 5 5 5 5 5 5 5 5 5 5 5 5 5 5 5 5 5 5 5 5 5 5 5 5 5 5 5 5 5 5 5 5 5 5 5 5 5 5 5 5 5 5 5 5 5 5 5 5 5 5 6 6 6 
5 5 5 5 5 5 5 5 5 5 5 5 5 5 5 5 5 5 5 5 5 5 5 5 5 5 5 5 0 0 0 0 0 5 5 5 5 5 5 5 0 0 0 0 0 5 5 5 5 5 5 5 0 0 0 0 0 5 5 5 5 5 5 5 0 0 0 0 0 5 5 5 5 5 5 5 5 5 5 5 5 5 5 5 5 5 5 5 5 5 5 5 5 5 5 5 6 5 6 6 
5 5 5 5 5 5 5 5 5 5 5 5 5 5 5 5 5 5 5 5 5 5 5 5 5 5 5 6 6 6 6 6 6 5 5 5 5 5 5 6 6 6 6 6 6 5 5 5 5 5 5 6 6 6 6 6 6 5 5 5 5 5 5 6 6 6 6 6 6 5 5 5 5 5 5 5 5 5 5 5 5 5 5 5 5 5 5 5 5 5 5 5 5 5 5 6 5 5 6 5 
5 5 5 5 5 5 5 5 5 5 5 5 5 5 5 5 5 5 5 5 5 5 5 5 5 5 5 0 0 0 0 0 0 5 5 5 5 5 5 0 0 0 0 0 0 5 5 5 5 5 5 0 0 0 0 0 0 5 5 5 5 5 5 0 0 0 0 0 0 5 5 5 5 5 5 5 5 5 5 5 5 5 5 5 5 5 5 5 5 5 5 5 5 5 6 5 5 5 6 5 
5 5 5 5 5 5 5 5 5 5 5 5 5 5 5 5 5 5 5 5 5 5 5 5 5 5 0 0 0 0 0 0 0 5 5 5 5 5 0 0 0 0 0 0 0 5 5 5 5 5 0 0 0 0 0 0 0 5 5 5 5 5 0 0 0 0 0 0 0 5 5 5 5 5 5 5 5 5 5 5 5 5 5 5 5 5 5 5 5 5 5 5 5 5 5 5 5 5 6 5 
5 5 5 5 5 5 5 5 5 5 5 5 5 5 5 5 5 5 5 5 5 5 5 5 5 5 0 0 0 0 0 0 5 5 5 5 5 5 0 0 0 0 0 0 5 5 5 5 5 5 0 0 0 0 0 0 5 5 5 5 5 5 0 0 0 0 0 0 5 5 5 5 5 5 5 5 5 5 5 5 5 5 5 5 5 5 5 5 5 5 5 5 5 5 5 5 5 6 6 5 
5 5 5 5 5 5 5 5 5 5 5 5 5 5 5 5 5 5 5 5 5 5 5 5 5 5 0 0 0 0 0 0 5 5 5 5 5 5 0 0 0 0 0 0 5 5 5 5 5 5 0 0 0 0 0 0 5 5 5 5 5 5 0 0 0 0 0 0 5 5 5 5 5 5 5 5 5 5 5 5 5 5 5 5 5 5 5 5 5 5 5 5 5 5 5 5 5 5 5 5 
5 5 5 5 5 5 5 5 5 5 5 5 5 5 5 5 5 5 5 5 5 5 0 0 0 0 0 0 0 0 0 0 0 0 0 0 0 0 0 0 0 0 0 0 0 0 0 0 0 0 0 0 0 0 0 0 0 0 0 0 0 0 0 0 0 0 0 0 0 0 0 0 0 0 0 0 0 5 5 5 5 5 5 5 5 5 5 5 5 5 5 5 5 5 5 5 5 5 5 5 
5 5 5 5 5 5 5 5 5 5 5 5 5 5 5 5 5 5 5 5 5 3 0 3 3 3 0 3 3 3 0 3 3 3 0 3 3 3 0 3 3 3 0 3 3 3 0 3 3 3 0 3 3 3 0 3 3 3 0 3 3 3 0 3 3 3 0 3 3 3 0 3 3 3 0 3 3 3 5 5 5 5 5 5 5 5 5 5 5 5 5 5 5 5 5 5 5 5 5 5 
5 5 5 6 5 5 5 5 5 5 5 5 5 5 5 5 5 5 5 5 3 3 0 3 3 3 0 3 3 3 0 3 3 3 0 3 3 3 0 3 3 3 0 3 3 3 0 3 3 3 0 3 3 3 0 3 3 3 0 3 3 3 0 3 3 3 0 3 3 3 0 3 3 3 0 3 3 3 3 5 5 5 5 5 5 5 5 5 5 5 5 5 5 5 5 5 6 5 5 5 
5 5 6 6 6 5 5 5 5 5 5 5 5 5 5 5 5 5 5 3 3 3 0 3 3 3 0 3 3 3 0 3 3 3 0 3 3 3 0 3 3 3 0 3 3 3 0 3 3 3 0 3 3 3 0 3 3 3 0 3 3 3 0 3 3 3 0 3 3 3 0 3 3 3 0 3 3 3 3 3 5 5 5 5 5 5 5 5 5 5 5 5 5 5 5 6 6 6 5 5 
5 5 5 0 5 5 5 5 5 5 5 5 5 5 5 5 5 5 5 0 0 0 0 0 0 0 0 0 0 0 0 0 0 0 0 0 0 0 0 0 0 0 0 0 0 0 0 0 0 0 0 0 0 0 0 0 0 0 0 0 0 0 0 0 0 0 0 0 0 0 0 0 0 0 0 0 0 0 0 0 5 5 5 5 5 5 5 5 5 5 5 5 5 5 5 5 0 5 5 5 
5 5 5 0 5 5 5 5 5 5 5 5 5 5 5 5 5 5 3 3 3 3 0 3 3 3 0 3 3 3 0 3 3 3 0 3 3 3 0 3 3 3 0 3 3 3 0 3 3 3 0 3 3 3 0 3 3 3 0 3 3 3 0 3 3 3 0 3 3 3 0 3 3 3 0 3 3 3 3 3 3 5 5 5 5 5 5 5 5 5 5 5 5 5 5 5 0 5 5 5 
5 5 0 0 0 5 5 5 5 5 5 5 5 5 5 5 5 3 3 3 3 3 0 3 3 3 0 3 3 3 0 3 3 3 0 3 3 3 0 3 3 3 0 3 3 3 0 3 3 3 0 3 3 3 0 3 3 3 0 3 3 3 0 3 3 3 0 3 3 3 0 3 3 3 0 3 3 3 3 3 3 5 5 5 5 5 5 5 5 5 5 5 5 5 5 0 0 0 5 5 
0 0 0 0 0 0 0 0 5 5 5 5 5 5 5 5 3 3 3 3 3 3 0 3 3 3 0 3 3 3 0 3 3 3 0 3 3 3 0 3 3 3 0 3 3 3 0 3 3 3 0 3 3 3 0 3 3 3 0 3 3 3 0 3 3 3 0 3 3 3 0 3 3 3 0 3 3 3 3 3 3 3 5 5 5 5 5 5 5 5 5 5 0 0 0 0 0 0 0 0 
0 6 6 6 6 6 6 6 0 0 5 5 0 0 0 0 0 0 0 0 0 0 0 0 0 0 0 0 0 0 0 0 0 0 0 0 0 0 0 0 0 0 0 0 0 0 0 0 0 0 0 0 0 0 0 0 0 0 0 0 0 0 0 0 0 0 0 0 0 0 0 0 0 0 0 0 0 0 0 0 0 0 0 0 0 0 0 0 5 5 0 0 6 6 6 6 6 6 6 0 
0 0 0 0 0 0 0 0 0 0 0 0 0 0 0 0 0 0 0 0 0 0 0 0 0 0 0 0 0 0 0 0 0 0 0 0 0 0 0 0 0 0 0 0 0 0 0 0 0 0 0 0 0 0 0 0 0 0 0 0 0 0 0 0 0 0 0 0 0 0 0 0 0 0 0 0 0 0 0 0 0 0 0 0 0 0 0 0 0 0 0 0 0 0 0 0 0 0 0 0 
5 0 0 0 0 3 3 0 0 0 0 3 3 0 0 0 0 3 3 0 0 0 0 3 3 0 0 0 0 3 3 0 0 0 0 3 3 0 0 0 0 3 3 0 0 0 0 3 3 0 0 0 0 3 3 0 0 0 0 3 3 0 0 0 0 3 3 0 0 0 0 3 3 0 0 0 0 3 3 0 0 0 0 3 3 0 0 0 0 3 3 0 0 0 0 0 0 0 5 5 
5 0 0 0 3 3 3 3 0 0 3 3 3 3 0 0 3 3 3 3 0 0 3 3 3 3 0 0 3 3 3 3 0 0 3 3 3 3 0 0 3 3 3 3 0 0 3 3 3 3 0 0 3 3 3 3 0 0 3 3 3 3 0 0 3 3 3 3 0 0 3 3 3 3 0 0 3 3 3 3 0 0 3 3 3 3 0 0 3 3 3 3 0 0 0 0 0 5 5 5 
5 0 0 0 3 3 3 3 0 0 3 3 3 3 0 0 3 3 3 3 0 0 3 3 3 3 0 0 3 3 3 3 0 0 3 3 3 3 0 0 3 3 3 3 0 0 3 3 3 3 0 0 3 3 3 3 0 0 3 3 3 3 0 0 3 3 3 3 0 0 3 3 3 3 0 0 3 3 3 3 0 0 3 3 3 3 0 0 3 3 3 3 0 0 0 5 5 5 5 5 
5 0 0 0 0 3 3 0 0 0 0 3 3 0 0 0 0 3 3 0 0 0 0 3 3 0 0 0 0 3 3 0 0 0 0 3 3 0 0 0 0 3 3 0 0 0 0 3 3 0 0 0 0 3 3 0 0 0 0 3 3 0 0 0 0 3 3 0 0 0 0 3 3 0 0 0 0 3 3 0 0 0 0 3 3 0 0 0 0 3 3 0 0 0 0 0 5 5 5 5 
5 5 0 0 0 0 0 0 0 0 0 0 0 0 0 0 0 0 0 0 0 0 0 0 0 0 0 0 0 0 0 0 0 0 0 0 0 0 0 0 0 0 0 0 0 0 0 0 0 0 0 0 0 0 0 0 0 0 0 0 0 0 0 0 0 0 0 0 0 0 0 0 0 0 0 0 0 0 0 0 0 0 0 0 0 0 0 0 0 0 0 0 0 0 0 0 0 5 5 5 
5 5 0 0 0 0 0 0 0 0 0 0 0 0 0 0 0 0 0 0 0 0 0 0 0 0 0 0 0 0 0 0 0 0 0 0 0 0 0 0 0 0 0 0 0 0 0 0 0 0 0 0 0 0 0 0 0 0 0 0 0 0 0 0 0 0 0 0 0 0 0 0 0 0 0 0 0 0 0 0 0 0 0 0 0 0 0 0 0 0 0 0 0 0 0 0 0 0 5 5 
3 3 3 2 2 2 2 2 2 2 2 2 2 2 2 2 2 2 2 2 2 2 2 2 2 2 2 2 2 2 2 2 2 2 2 2 2 2 2 2 2 2 2 2 2 2 2 2 2 2 2 2 2 2 2 2 2 2 2 2 2 2 2 2 2 2 2 2 2 2 2 2 2 2 2 2 2 2 2 2 2 2 2 2 2 2 2 2 2 2 2 2 2 2 2 2 2 2 3 3 
3 3 3 2 2 2 2 2 2 2 2 2 2 2 2 2 2 2 2 2 2 2 2 2 2 2 2 2 2 2 2 2 2 2 2 2 2 2 2 2 2 2 2 2 2 2 2 2 2 2 2 2 2 2 2 2 2 2 2 2 2 2 2 2 2 2 2 2 2 2 2 2 2 2 2 2 2 2 2 2 2 2 2 2 2 2 2 2 2 6 2 2 2 2 2 2 6 2 2 3 
3 3 3 3 2 2 2 2 2 2 2 2 2 2 2 2 2 2 2 2 2 2 2 2 2 2 2 2 2 2 2 2 2 2 2 2 2 2 2 2 2 2 2 2 2 2 2 2 2 2 2 2 2 2 2 2 2 2 2 2 2 2 2 2 2 2 2 2 2 2 2 2 2 2 2 2 2 2 2 2 2 2 2 2 2 2 6 6 6 6 2 2 2 6 6 6 6 2 2 2 
3 3 3 3 3 2 2 2 2 2 2 2 2 2 2 2 2 2 2 2 2 2 2 2 2 2 2 5 5 5 5 2 2 2 2 2 2 2 2 2 2 2 2 2 2 2 2 2 2 2 2 2 2 2 2 2 2 2 2 2 2 2 2 2 2 2 2 2 2 2 2 2 2 2 2 2 2 2 2 2 2 2 2 2 2 2 2 2 2 6 2 2 2 2 2 2 6 2 2 3 
3 3 3 3 3 3 2 2 2 2 2 2 2 2 2 2 2 2 2 2 2 2 2 2 2 2 5 5 2 2 5 5 5 5 5 5 5 5 5 2 2 2 2 2 2 2 2 2 2 2 2 2 2 2 2 2 2 2 2 2 2 2 2 2 2 2 2 2 2 2 2 2 2 2 2 2 2 2 2 2 2 2 2 5 2 2 2 2 2 2 2 2 2 2 2 2 2 3 3 3 
